

NO pics/wall1.xpm
SO pics/wall2.xpm
WE pics/wall3.xpm
EA pics/wall4.xpm







F 81,255,31





C 53,168,250




1111111111111111
1000000000001001
1000010000001001
1111000001111001
1000000001000001
1000000001000001
100101110000E001
1000001000000001
1111101001111001
1000000000000001
1111111111111111