 
NO textures/wood0.xpm
SO textures/wood1.xpm
WE textures/wood2.xpm
EA textures/wood3.xpm








F 81,255,31





C 53,168,250


        1111111111111111111111111
        1000000000110000000000001
        1011000001110000000000001
        1001000000000000000000001
111111111011000001110000000000001
100000000011000001110111111111111
111111111111111111111


11111111111111111111111111111
111101111111110111000000100011      
1111011111111 11011101010010001  
110000001101010111000000100011        
11111111111111111101111111111             
                 111                            
                 101
                 101
111111111111111111101111111111111111
10000000000000001100000010001
10000000000000001101010010001
11000001110101011111011110001
11110111 1110101 101111010001
11111111 1111111 111111111111