        1111111111111111111111111
        1000000000110000000000001
        1011000001110000000000001
        100100E000000000000000001
111111111011000001110000000000001
100000000011000001110111111111111
111111111111111011111
              101
              101
11111111111111101111111111111
111101111111110000000000100011             1111
1111011111111111011101010010001           1100111
110000001101010111000000100011            1001
11111111111111111101111111111              11
                 111                            
                 101
                 101
111111111111111111101111111111111111
10000000000000001100000010001
10000000000000001101010010001
11000001110101011111011110001
11110111 1110101 101111010001
11111111 1111111 111111111111