0000000000000000
0000000000001000
0000010000001000
0111000001101000
0000000001000000
0000000001000000
0001011100000000
0000001000000000
0000001001111000
0000000000000000
0000000000000000